###########
#E        #
########  #
#         #
# ###  ####
# ###     #
# ######  #
# #A      #
###########


