###############################
# E       #   #           #   #
# # ##### # # # # ####### # # #
# #     # # # # #         # # #
# ##### # # # # ##### ##### # #
#       # # # #       #     # #
######### # # # ####### #######
#         #   #               #
# ### ####### # ### ####### ###
# #   #   #   #   # #       # #
# # ### # # # ### # # ####### #
# # #   # A #     # # #       #
# # # ############# # # #######
# #   #     #   #   #         #
# ##### ### # # # # ######### #
#           # #   # #   #     #
###############################
