#######
#E    #
##### #
#     #
# ### #
# #   #
###A###


