#######################
#      E#     #  A  # #
# ##### # ### # ### # #
# #       #   #     # #
# # ####### ####### ###
# # #     # #         #
# # # # # # # ### #####
# # # # # # # #       #
# # # # # # # # ##### #
# # #   #     # #   # #
# # ##### ### # # # # #
# # #     #   # # # # #
# # # # ### ### # # ###
# #   # #   #   # #   #
# ### # # ### ### ### #
#   #   #   #         #
#######################

