#############################################################
#                       #    E#A        #   #       #   #   #
# ##################### # ############# # # # ##### # # # # #
# #       #       #   # #     #         # # # #     # # # # #
# # ##### # ##### # # # ##### # ######### # # # ##### # # # #
# # #     #     # # # # #     #           #   # #     # # # #
# # # ######### # # # # # ##################### # ##### # # #
#   # #   #   # #   # # # #       #   #   #     # #     # # #
##### # # # # # ##### # # # ##### # # # # # ##### # ##### # #
#     # # # # # #   # #   # #   # # # # # # #     #       # #
# ##### # # # # # # # ##### # # # # # # # # # ############# #
#     # # # #   # # #     # # # #   #   #   #     #       # #
##### # # # ##### # ##### # # # ################# # ##### # #
#     # # # #     # #     #   #     #             # #     # #
# ##### # # # ##### # ############# # ############# # ##### #
#     # #   #     # #     #       # #         #   # #     # #
##### # ######### # ##### # ##### # ######### # # # ##### # #
#     #     #   # #       # #     # #   #     # # # #   # # #
# ######### # # # ######### # ##### # # # ##### # # # # # # #
#     #     # # #           #     # # # #     # # # # # # # #
##### # ##### # ################# # # # ##### # # # # # # # #
#     #       #             #   # # # #       # # # # #   # #
# ######################### # # # # # ######### # # # ##### #
# #                   #     # # #   # #   #     #   #       #
# # ################# # ##### # ##### # # # #################
# # #           #     #     # #       # # #     #       #   #
# # # ######### # ######### # ######### # ##### # ##### # # #
# # # #         # #       # # #   #   # #     # #     # # # #
# # # # ######### # ##### # # # # # # # ##### # ##### # # # #
# # # #           # #     # # # # # # # #     #       #   # #
# # # ############# # ##### # # # # # # # ################# #
# # #         #     #     # # # #   # # #     #       #   # #
# # ######### # ######### # # # ##### # ##### # ##### # # # #
# #         # # #         #   # #   # #     # # #     # # # #
# ######### # # # ############# # # # ##### # # # ##### # # #
#     #   # #   # #             # # #     # # # # #     #   #
##### # # # ##### # ############# # ##### # # # # # #########
#     # # # #     # #   #   #     # #   # # # # # #     #   #
# ##### # # # ##### # # # # # ##### # # # # # # # ##### # # #
#       # # # #   # # # # # #     # # # # # #   #     # # # #
######### # # # # # # # # # ##### # # # # # ######### # # # #
#         # # # # #   #   #       #   # # #         # # # # #
# ######### # # # ##################### # ######### # # # # #
#         # # # #     #   #   #   #     #         # # # # # #
######### # # # ##### # # # # # # # ############# # # # # # #
#   #     # # # #     # # # # # # #         #     # # # # # #
# # # ##### # # # ##### # # # # # ######### # ##### # # # # #
# # # #     #   # #     #   #   #         # #       # # # # #
# # # # ######### # ##################### # ######### # # # #
# #   # #         #             #         # #   #   # # # # #
# ##### # ##################### # ######### # # # # # # # # #
#       # #           #         # #       # # # # # #   # # #
######### # ######### # ######### # ##### # # # # # ##### # #
#         # #         #     #     # #     #   # # #       # #
# ######### # ############# # ##### # ######### # ######### #
#     #     #         #     #     # #         # # #         #
##### # ############# # ######### # ######### # # # #########
#     #         #     #         # #     #     #   #         #
# ############# # ############# # ##### # ################# #
#               #               #       #                   #
#############################################################

