###################################
#E                       # ## # # #
##### ###### ###### ###### ###### #
# # # ## # # ## # # ## # # ## # # #
# ### ## ### ## ### ## ### ## ### #
# ### ## ###  # ### ## ### ## ### #
############# #####################
############# #####################
# # # ## # # ## # # ## # # ## # # #
##### ###### ###### ###### ###### #
# # #    # # ## # # ## # # ## # # #
# ### ## ###        ## ### ## ### #
#A    ## ### ## ### ## ### ## ### #
##### ############# ###############
##### ############# ###############
# # # ## # # ## # # ## # # ## # # #
##### ###### ###### ###### ###### #
# # #               ## # # ## # # #
# ### ## ### ## ### ## ### ## ### #
# ### ## ### ## ### ## ### ## ### #
###################################