#############################################################
#       #     #     #        E        #   #         #       #
# ##### # ### # ### # ####### ####### # # # ####### # ##### #
# #       #   #     #     #   #     # # #     #   #       # #
# # ####### ####### ##### # ### ### # # ##### # # ####### # #
# # #     # #     #     #   #   #   #       #   #       #   #
# # # # # # # ### ##### ##### ### ##### ### ########### #####
# # # # # # # #       # #     #       # #     #       # #   #
# # # # # # # # ##### # # ##### ##### # # ### # # ### # # # #
# # #   #   # # #   # # # #     #   #   #       #     #   # #
# # ##### ### # # # # # # # # ### # ### ################### #
# # #     #   # # # #   # # # #   #     #         #         #
# # # # ### ### # # ##### # # # ######### ####### # ####### #
# #   # #   #   # #   #   # #   #   #   #     #   # #     # #
# ### # # ### ### ### # # # ### # # # # ##### # # # # ### # #
#   #   #   #           # #   #   #   # #   #   # # # #   # #
### ### # # ######### ### # # ### ##### # # # ### # # # ### #
#   #   # #   #       #     #     #   #   # # #   # # #     #
# # # ### # # # # ##### ##### ##### # ### # # # ### # ##### #
# # # #     #   #     # #   #     # #     # # #     #     # #
# # # # # ##### ##### # # # ### # # ####### # ### ####### # #
# # #   # #     #   # #   #     #   #     #     #   #     # #
# # ### # # ##### # # ############# # ### ### # ### # ##### #
# #     # # #   # #   #   #       # #   # #   #   # # #   # #
# ####### # # # # # ### # # ##### # ### # # ##### # # # # # #
#       # #   # #   #   # # #   # #     # #     #   # # #   #
# ### # # ### # ##### ### # # # # # ### # ##### ### # # # # #
#   # # # #   # #   #     # # # #   #   #     #   #   #   # #
### # # # # ### # # # ##### # # ##### ##### # ### ### ##### #
#   #   #     # # #   #     # # #         # #       # #     #
# # ######### # # ### # ##### # # ####### # ##### # # # #####
# # #       #   #   # #       #   #   #   #     # #   # #   #
# # # ##### ####### # ######### ### # # ####### # ##### # # #
# #   #   #           #       # #   # #         # #   # # # #
# # ### # ############# ##### # # ### ######### # # # # # # #
# # #   # #     #       #   # #   #   #     #   # # #   # # #
# # # ### # ### # # ##### # # ##### # # ### # ### # ##### # #
#   #             # #   # # # #   # #     # #   #         # #
# ############### # # # # # # # # # ##### # # # ########### #
#         #   #   #   # # # # # #     #     # # #         # #
##### ### # # # ####### # # # # ##### # # ### # # ##### # # #
#   #       # # #     #     #   #   # # #     #   #     #   #
# # ######### # # ### ########### # # # ########### #########
# #   #     #   # #       #   #   # # #             #       #
# # # # ### ### # # ##### # # # ### # ######### ##### ##### #
#   #         #   #     #   # # #     #       #       #   # #
##### ##### # ### ##### ##### # # ##### ##### ### ##### # # #
#   # #   # #     #   #   #   #   #   # #       # #   # #   #
# # # # # # ####### # ### # ####### # # # ##### # # # # # ###
# # # # #   #     # #     #         #   # #   #   # # # #   #
# # # # ##### ### # # ############# ### # # # ### # # # ### #
#     #     # #   #   #           #   # # # # #   # # # #   #
########### # # # ##### # ####### ### # # # # # # # # # # # #
#         # #   # #   # #       #   # # # # #   #     #   # #
# ####### # ### # # # # ##### # ### # # # # ############### #
#         # #   # # #   #     #     # # # #   #         #   #
##### ### # # ### # ### # ######### # # # ### # ####### # # #
#     #   # # #   #   # # #       #   # # #   # #       # # #
# ### # ### # # ##### # # # # ### ### # # # ### # ##### # # #
#     #     #         #     #  A#     #   #     #       #   #
#############################################################

