#########################
#                       #
# ##################### #
# #       #       #   # #
# # ##### # ##### # # # #
# # #           # # # # #
# # # ######### # # # # #
#   # #   #   # #   # # #
##### # # # # # ##### # #
#     # # # # # #  E# # #
# ##### # # # # # # # ###
#     # # # #     # #  A#
#########################





































