# ###
#   #
#sss#
#sxs# 
#sss#
#   #
#   #
#sss#
#sxs# 
#sss#
#   #
#   #
#   #
#   #
#####
